#@##############
#,#,,,#,,,,@...#
#,#,,,#,,,,#####
#,##,#####,#####
%,,,,,,,,,,,,,,#
#,,,,,,,,,,,,,,#
#,,,,,,,,,,,,,,#
#,,,,,,,,,,,,,,#
######,,,#######
#,,,,,,,,,,,,,,#
#,,,,,,,,,,,,,,#
#,,,,,,,,,,,,,,#
#,,,,,,,,,,,,,,#
#,,,,,,,,,,,,,,#
#,,,,,,,,,,,,,,#
################